000003000000060000004000000000001000000
888803000000060004444000000000001100000
000883000000066604000000000000000110000
000003333000000664000000000000000011000
000000003000000044000000000000000001110
555555003333333330000000000000000000010
000005500000000033000000000000000000010
000000555000000003000000000000000000010
000000005555000003000000000000000001110
000000000005000003333000000000000001000
000000000005500000003000000000000011000
000000000000500000003333333333000110000
000000000555500000000000000003331100000
000000555500000000000000000000001000000
000055500000000000000000000000001100000
000550000000000000000000000000000110000
055500000000000000000000000000000011099
050000000000000000000000000000000001110
055000000000000000000000000000000000017
005000000000000000000000000000000111110
005500000000000000000000000000000100000
000550000000000000000000000011111100022
000050000000000000000000000010000002220
000055500000000000000000111110000022000
000000500000000000000000100000000220000
000000500000000000000000111000000200000
000000550000000000000000001111000220000
000000050000000000000000000001000020000
000000050000000000000000011111002220000
000000050000000000000000010000002000000
000000050000000000000001110000002220000
000000050000000000000111000000000022000
000005550000000000000100000000000002000
000005000000000000000100000000000002220
000005550000000000000100000000000000020
000000055000000000111100000000000000220
000000005555500001100000000000000000200
000000000000500001000000000000000000220
000000000011111111000000000000000000020
000000000010000000000000000000000000020
000000001110000000000000000000000000020
000000001000000000000000000000000222220
000000001000000000000000000000000200000
000000001000000000000000000000000200000