05000700108000000000000000900060000
05000771108800000000000000900066660
05000011000800000000000000900000060
01111110000800000000000009900006660
01000000888800000000000009000006000
01000008800000000000000009000666000
41008888000000000000000006666600000
01118000000000000000000066000000000
00011000000000000000000660000000000
00001000000000000000006600000000000
00001000000000000000006000000000000
00001100000000000000066000000000000
33330110000000000006660000000000000
00030010000000000006000000000000000
03330011000000000666000000000000000
03000001000000000600000000000222222
03000001100000000600000000000200000
03000000100000000600000000000220000
03000001100000000600000000000022000
03333331000000666600000000000002220
00000001111166600000000000000000020
00000000000100000000000000000000020
00000000000100000000000000000000020
00000000000110000000000000000000020
00000000000011000000000000000002220
00000000000001000000000000000022000
00000000000001000000000000000020000
00000000000001100000000000000020000
00000000000000111000000000000022220
00000000000000001000000000000000020
00000000000000001110000000000002220
00000000000000000011110000000022000
00000000000000000000010000000020000
00000000000000000000010002222220000
00000000000000000000010002000000000
00000000000000000000011102000000000
00000000000000000000000111111111000
00000000000000000000000000000001110
00000000000000000000000000000000010
00000000000000000000000000000000010
00000000000000000000000000000000110
00000000000000000000000000000000100
