00006000000000208030000000000
00006660000000233330000000000
00000060000000200000000000000
00006660000000200000000000000
44006000000000222000000000000
04444000000000002220000001111
00004400000000000022200001000
00000400000000000000222221000
77000444000000000000000011000
07700004000000000000001110000
00700004400000000000001000000
00700000440000000000001100000
99777700040000000000000110000
00000700040000000000000011110
55500770040000000000000000010
00500077440000000000000000010
00550004400000000000000000010
00050004000000000000000001110
00055004000000000000000011000
00005554444444000001111110000
00000000000004000001000000000
00000000004444000001100000000
00000000044000000000110000000
00000000040000000000011111100
00000000040000000000000000110
00000000044000000000000000010
00000000004440000000000001110
00000000000040000000000001000
00000000000044440000000001100
00000000000000044444444000100
00000000000000000000004000110
00000000000000000000004400010
00000000000000000000000441110
00000000000000000000000001000
*****************************