0000000100000000000000000000000
0000000100000000000000000000000
0000000100000000000000000000000
0000000100000000000000000000000
0000000111110000000000000000000
0000000001011000000000000000000
0000000001001100000000000000000
0000000001000000000000000000000
0000000001000000000000000000000
0000000001110000000000000000000
0000000000000000000000000000000
0000000000000000000000000000000
0000000000000000000000000000000
0000000000000000000000000000000
0000000000000000000000000000000
0000000001001100000000000000000
0000000001000000000000000000000
0000000001000000000000000000000
0000000001110000000000000000000
0000000001001100000000000000000
0000000001000000000000000000000
0000000001000000000000000000000
0000000001110000000000000000000
0000000001001100000000000000000
0000000001000000000000000000000
0000000001000000000000000000000
0000000001110000000000000000000