0030000804000000000009020000000
0030000444000000000009220000000
0033004400000000000000200077777
0003344000000000000000200070000
0000300000000000000002200070000
0333300000000000000002000077000
0300000000000000000002222207000
0330000000000000000000000207111
0033000000000000000000001111100
0003330000000000000000011000000
0000030000000000000000110000000
0000030000000000000000100000000
0000033000000000000000100000000
0000003333330000000000100000000
0000000000033330000000111000666
0000000000000030000000001066600
0000000000000030000000001110000
0000000000000033000000000011000
0000000000000003000000000001555
0000000000000003000000000011000
0000000000000033000000000010000
0000000003333330000000000011000
0000000033000000000000000001110
0333333330000000000000000000010
0300000000000000000000000000010
0333000000000000000000000011110
0003300000000000000000111110000
0000300000000000000011100000000
0000330000000000000010000000000
0000033000000000000011000000000
0000003300000000000001000000000
0000000300000000000001000000000
0000033300000000000011000000000
0000330000000000000010000000000
0000300000000011111110000000000
0033300000000110000000000000000
0030000000000100000000000000000
0030000000000100000000000000000
