000000010000000
000000010000000
000000010000000
000000010000000
000000011111000
000000000101100
000000000100110
000000000100000
000000000100000
000000000111000
000000000000000
000000000000000
000000000000000
000000000000000
000000000000000